6 13 31
###############################
#     *  x  # *  ** * *      *#
# # # #*#*# # #*# # # # # #*# #
#    * * ***  **     *    **  #
##*# # #    # # # # # # # # #*#
#b      #  *     **      *  **#
# # #*# # # # # #*#*#*#*# # # #
##  *        x*   * ** *      #
# # # # #*# # # # #           #
#b# *           *             #
# ### # # # # # # #          *#
#p  ***                       #
###############################